1111111
1EPC111
1000001
1111111