1111111
1EPC111
1P00001
1111111